type octile
height 65
width 65
map
..@.@.@.@.@.@.@.@.@.@.@.@.@.@.@.@.@.@.@.@.@.@.@.@.@.@.@.@.@.@.@..
....................@...@...............@.......@...@.@..........
@.@.@..@..@@@........@@.......@...@.............@...............@
..@.@...........@...................@...@.................@......
@.....@.....@.......@.@...@........@...@...@....@@@.@.@.......@@@
..@.@.....................@.......@..............................
@....@............@.....@.......@.@...............@.@.@...@...@.@
................@...................@.@.......@.........@...@....
@....@.@@...@.....@.@@@@...@..@@..@.........@......@........@@..@
........@...........@...........@.@...@..........................
@.....@..@@.........@.@.@.@.@..@@...@...@...@.@.@.....@.@@......@
......................@...@.........@.......@.@.......@.@...@.@..
@.@..@..@...@...@.@.....@..@......@...@@..@.@...@.@@@.@.@.......@
....@.@.....@...@...........@.......@...........@...@............
@...@...@.@.............@@....@...@....@....@...@.....@...@.....@
..@.....@...@.......@...@...@...@...............@.........@......
@@.....@@@.@.@@..@@.@@..@@@.@...@.@..........@...@.@..@.@@@.@...@
..@.........................................@.......@.........@..
@...@.......@@.......@@...@@@..@........@...@.@....@....@...@...@
....@.......................@.......@............................
@@..@.@...@...@...@.@...@....@..@.........@...@......@...@....@@@
....@...@.......@...................@...........@...........@....
@...@@@.@.@.@.@.@.....@.............@......@@...@...@..........@@
..............@.........@...........@.......@.@.@................
@@...@@.@@@@...@.....@.@........@.@...@..@.......@@@....@...@..@@
....@.........@.....@...........@...............@................
@......@@.............@.....@.@.@.@.@...@..@..@..@@.....@.@.....@
................@.......@.......@...................@............
@.....@....@...@....@.@...@...@...@...@.@........@.........@....@
..@...@...................................@.@.......@...@.@.@....
@.........@...@...@@..@.@.@@..@@@.....@.@.@.@.@........@@...@.@.@
..........@.................@...@...............@................
@@@.....@.....@.@..@@......@@@.@@...@@@.@..@@..@.@@..@..@.......@
....@...........................@.......................@........
@.......@@..................@......@@........@..@...@@......@.@.@
......@.....................@...........@...@....................
@......@.@@.@..@@.....@......@..@.@@@.@.@.........@@.@@.@.@@...@@
........@.......@.@.........@.@.............@.......@............
@......@@@..@.@.@...@@@.@...@.@.@...@.@...@...@.@@@.@...@.....@.@
..@.........................@.......@...@........................
@@.......@.@....@........@......@@....@...@.......@@...@@@@.@@..@
....@...@...@...@.......@...@.......@...@.............@.....@....
@.@....@@..@@......@.....@@.........@.....@.....@.........@...@.@
........@.....................................@..................
@.@..@@.@.............@.@....@...@....@@.......@.@@...@@..@.@@..@
....................@...........@.......@...........@.@..........
@.@.....@@..@.@...@.....@.@.......@@..@@.@...@@.......@.....@@..@
........................@...@...@.......................@...@....
@.....@.@....@.@.@............@..@......@.@@.....@.......@.@..@.@
....@...............@...........@.....@.....................@....
@.@.....@...@...............@.......@.@.@.......@.@...@.@.@...@.@
..@.@...@.....................@.........@........................
@....@..@.@........@@.@..@@.@.@.@.@..@@.@...@.....@.....@.@....@@
................................@.......@.@......................
@...@......@@.......@@...@..@@@.@.@.....@.................@.@.@.@
................................@...@...........@...@...@.....@..
@.@.....@@.@..........@..@..@..@@@......@.@.........@.@@...@@..@@
......@.....@...@...........@...............................@....
@...@.@.@@@...@.@.....................@.............@...@.....@.@
........................@.....................@.@.....@...@......
@.@@.@.......@........@.@...@@@.@.@........@@.@........@......@.@
........@...@...@.@.........................@....................
@.@...@.......@...................@.@..@........@.......@.@.....@
................@.......@...............................@...@....
..@.@.@.@.@.@.@.@.@.@.@.@.@.@.@.@.@.@.@.@.@.@.@.@.@.@.@.@.@.@.@..