type octile
height 129
width 129
map
..@.@.@.@.@.@.@.@.@.@.@.@.@.@.@.@.@.@.@.@.@.@.@.@.@.@.@.@.@.@.@.@.@.@.@.@.@.@.@.@.@.@.@.@.@.@.@.@.@.@.@.@.@.@.@.@.@.@.@.@.@.@.@..
....@...@.......................@...@.......@...........................@...@...@...@.......@.......@.....@...@.....@............
@...@...@.@...@.@.........@...@.@.@.@......@..@...@.....@....@....@@......@@@.....@.........@..@......@..............@..@..@...@@
..@.....@...@...@.......@.......@.....................................@.................@........................................
@.@.@@@...@...........@..@..@.......@..@@..@..@.....@.@@..@.@..@....@.@@.....@..@..@....@@.....@@..@@....@@.@@..@@..@.....@@..@.@
..............@.......@.@.....................@...@.........@.@.@...@.............@.............@.@...........@.......@.....@....
@...@.....@@............@...@.@@@.@.@.@...@.....@.@.@.............@.@@...............@@.....@...@.......@...@...@.@.@.....@@..@.@
....@.............@.............@.......@.............@.........@...@.......@...@.......................@...@...@................
@.@@@.....@....@@.@@..@...@@.....@@.@..@..@...@......@..@@@@.@..........@@.@@@...@@@.@@.@@@.@@....@.@@.@.....@..@.............@.@
....@...................................................@.......@.......................................@.@.............@........
@@......@@....@.@...@.....@....@..@.....@.........@.@...@...@.@.@..@...@..........@.@.......@.@...@.......@.@@........@...@....@@
........@.......@...........................@...@...@...............@.............@.........@.......@...............@...@........
@..@.@....@.@@.....@....@....@..@.........@....@..@........@...@@...@.@...@.@...@...@....@.@@.@.@.@.@...@.@@..@..@@.@.@.@...@.@.@
................@...@.@.........@...@...@...@...............@.................@.@.......@.....................@..................
@.@.....@.......@.@........@..@...@...@@@..@@.....@@@.@...........@...........@..@@...@.@...@...@...........@.@...........@...@.@
....@...........@.......@...........@...@.............@.................@.@.........@.....@...@.......@...............@.......@..
@@@..@.@..@..@..@.@@.@@....@@@@@....@..@@@@...@..@@@....@....@@@.@.@@..................@...@@...@.@....@@@..@@......@@@.@...@@@.@
....@...@...@...@...@...@...........@.........@.@.......@.......@...............@.......@...........@.............@.....@...@....
@...@.@...@....@..@.......@......@.....@..@...@..@......@.......@@@.@..@..@.........@.@@.@......@.......@.@.........@...@.....@.@
....@...................@...@...@...@.................@.@.....................@.................@................................
@@..@....@@..@@.@.......@@.@@..@..@....@@....@..@@..@@@.....@....@..@@..@..@..@.@...@.@...@.@.@.@..@@@@............@..@@@.@.@@..@
....@.......@...@.......@.......@.......@.......@...@.......@...........@.......@...........@...@.......@...............@........
@.....@...@@.......@.@........@...@..@..@.@.@...@.....@...@.@.........@.......@..@....@...@.@...@.....@@@...@......@@...@@..@...@
..@.................................@...................@.......@.......@...@...........................................@........
@@...@....@..@..@.@....@..@..@.@..@....@.....@@@@@@@@@........@...@@.@@@@@..@..@@.....@...........@....@.@@...@@.....@@..@..@@..@
..........................@.............@...@...@...@...........................................@.....@...@.............@........
@...@......@..@.....@.@.@.@.......@...@...@.......@.@.......@.@..@@.@......@@.......@.....@..@....@.@.......@...........@...@@..@
........................@.......@...............@.......@...........@.......@.@.....@...@...@...........@........................
@@@.@.@.....@@........@.@...@..@@.@@.....@..@........@..@..@....@...@.@..@..@....@....@.....@@@.....@.......@.......@@....@....@@
....................@.......@.........................................................@.........@...@.......................@....
@.@.@.@.@.@@...@@.@...............@..@....@...@.@............@..@....@................@....@......@@.........@@.@.@.......@.@.@.@
........@.............@.@.......@.......................@.......@.......@...................@.......@...@.......@................
@@@..@.@@.....@....@.@@........@.........@@.....@@.......@@...@..@@....@.@@....@.@@.@@......@..@@@@@..@...@...@..@@@.........@..@
................................@...........@...........@.......@...@.......@.........@...........................@.....@........
@.@.....@..@..@.@.....@.@.@...............@@.......@@.@.@...@...@.@.............@.....@....@..@.....@.@.......@.@...@@..@.......@
........@...@...........................@...........................@...............@...........@.........@.....@.............@..
@@....@@@....@...@@.@.@@.@.....@.@......@.@@..@@@@................@..@....@.@@@..@........@.@.@...@....@..@@...@.@....@@@.@..@..@
....@.....@.............................@...............@...@...................@...@.........................@.@.....@..........
@@...@@.@.@.@@....@@@...@@......@....@.......@..........@.......@...@.@...@.....@@@...@...@.....@...@...@.@.@.........@.@...@...@
........@.............................................@.....@...@.......@...@...@.....@.........@.................@..............
@.@.......@@.@@...@....@.....@...@..@..@....@@.......@...@.......@........@@@..@......@@@.@.@.@....@.@....@@@.@..@....@@...@....@
....@...........................@.......@...@...@...............@...........@...........@.@.......@.............@.........@.@.@..
@....@..@.........@...@@..@...@@@.@.@.....@...@.......@...@...@.@...@.@.@.........@.....@.@.@...@.@..@......@@..@..@...@........@
........@.....@.........@.....................................@...@.........@.....@...........@.........@...@....................
@.@..@@.@........@@.@@.....@@@..@..@.@....@.@.....@@...........@@@@.....@.@.@.@........@@..@...@@...@@.....@@.@@@..@.....@..@...@
......@.....@...........@.......................@.......@...@...@...@...@.....@.@.......@...........@............................
@...@......@..@@..@...@@.....@@.......@.@.@.@....@@...@......@@...@.@@@...@.@.....@.........@...@...@.......@.@.....@...@.@..@@.@
........................@...............@...........@.@.........@...................................@...................@...@....
@@...@@@...@.............@.@.@.........@.@...@......@@@.@...@..@.....@..........@.@..@..@@@.@@..@.@@.@@@.@.@........@.@@......@.@
....@.............@.....@.......@.......@...@.....@.........@...........@...........@...@.............@.........@.@.....@........
@.@...@...@.....@.@...@...............@.@.@.....@.@...@.@.@.@.@.....@...@.....@.@@....@.@.@...@.@@@.@.@.......@.@.......@.@..@@.@
................................@.......@...............@...........@...................@...@...................@...@...@........
@...@.@.@..@.@....@.@........@......@.@@.......@.............@@...@...@@@...@.@..........@....@.......@..@.....@@.@@....@.@.@.@.@
........................@.......@.......@.......@...@...@.......@.@.@...........@...............@.......@...........@.....@......
@.......@@@...@...@@..@...@.@.....@@.@@.@.@.@@.....@@.....@...@.....@.@.........@.@.@@@...@.@.@...@.@...@...@.@.....@@..@...@...@
......@.@.......................@...............@...@.....@.......................@.........@...........................@........
@@@.@..@.@..@...@@.@.@@.@...@@@.@..@..@@@.@@.@.....@@...@@....@..@@.@...........@.....@.@@..@.@........@...@...@.......@.....@..@
......@.@...@.................@.................@...@.........@.............@...@...........@...@...@.........@.@................
@@....@...@...@.......@.........@.....@.......@@........@.......@.....@......@@.............@.......@.@.@.@.@...........@.@.@...@
..........@...............@.........@.....@.................@.............@.....@...@...........@.......@.......@.......@........
@.@..@..@.....@...@.....@...@...........@.@........@...........@.@..@..@@.@...@........@..@..@.....@.@@.....@.......@..@..@.....@
....@...@.......@...@...@...@...@...@...................@...@...@.....@.....@...............@...........@.@.........@...@........
@............@@.......@.@...@.@.....@.@.@.......@.........@.@...........@....@@...@...@@..@@@...@.@.....@.@...@.@...@.@.........@
................@.@.........@.........@.@...@...@.@.................................@.....................................@......
@.@@@...@..@@@.@..@@.@..@..@...@@@.@@@...@@.....@.@..@...@.@@......@...@.......@@.@.....@.@@.@.@...@@..@....@.@....@@....@.@@@@.@
................@...........................@.............@.....@.@.............@...............@...................@.@.......@..
@...@.......@...@...@.@@..@.....@..@@.@@......@.@...@.....@.@.@@@.@.@@@....@..@@..@@@@..@.............@@@.@......@........@@....@
........@.......@...............................@...................@.......@...................@...@...@.......@................
@@..........@@..@@@.............@..@....@.@@@..@.....@....@.........@....@.@@@........@.@@@....@@....@........@...@@@.@@@.@..@..@
........@...............@...@.........................@.............@...........................@...@...@.................@.@....
@.....@@....@.@.....@.....@...@.@.............@..@..@.......@...@.@...@.@..@@...@.@.....@..........@@@..@@......@.......@.@.@.@.@
............@.@.@.......@...........@...............@.......@...@.......................@...@...@.......@.....@.....@.@..........
@@@...@..@@@....@..@...@@@...@..@@@@@....@.@.......@@.@..@@@..@...@.@.....@...@@.@@@@.@..@@..@.@....@......@......@@@....@@.@..@@
....@...........@.............@.@...@.........@...@.........@...........................................@...@...@...........@....
@..@..@.......@.....@@........@.@..@..@@@.@.........@.................@.@.@.@.....@.......@...@.....@.@...........@.......@.@...@
................@.@.@.................................@...............@.@.@.....@.@.....@...@...........@.......@...@...@.@......
@...@...@@..@.@........@@.@.@@@...@@......@...@@......@...@.@...@..@@...@.@...@@.@@.....@@.@@@.....@@@.@.@..@@.@........@.@..@..@
..........................................@.....@.....@.@...@.....@.................@...@.......@...............@.......@........
@@@......@..........@...@.@.....@.@...@.......@.....@....@....@...@.....@.@.....@.......@.@.@.@..@..@.@..@..@@..@......@..@.....@
....@...................................@.........@.................@.@.........@...............@...............@...@............
@...@..@.@.......@..@.@..@....@..@@@@...@@.@......@.@@.@@@@@......@.@.@@..@.....@...@.@@..@.@@.........@..@@@.@......@.@@...@@..@
............................................@...@...............................@...............@...............@.............@..
@.......@.@.@.@.@.@.@@@..@@..........@@..@..@..@@.@.@.@.@.@.....@.@...@@.@..@......@....@...@........@@.@.......@.@.@.......@...@
........@...@...........................@...........................................@...@...............@...........@............
@....@..@@@..@..@.@........@@.@.@.....@.@@@...@.@.......@....@....@@...@...@..@.........@..@@..........@....@@..@...@.@.......@@@
....@...............@.......@.@...@.............@.......@...............@...............................@...@...........@........
@.........@.....@@...@..@.@.....@.....@...@...@..@..@...@....@....@.....@.@...@...@...@.@@..........@.@.@......@@...@...@.....@.@
..............@.................@.....@...............@.@.......@...@...........@...@...........@.....................@..........
@.@....@....@...@@@@@.@.@..@@.@@........@.@...@..@........@.@@.@@@@@..@...@.@@@...@..@@..@.@@..@@..@.@..@.@..@@..@....@...@.@@..@
............@...@.......@.......................@.@.....@...@...........................@...........@...........@.........@......
@......@..@.............@.......@...@...@@...@..@.@...@.@.....@..@@...@@@...@...@...........@.@.@.@..............@@.@@......@...@
....................@.......@...........@...........@...............................@...@...@...@.@.....@...@...........@........
@.@.........@...@.@@@...@.@.@...@............@....@..........@@.....@..@@.@..@..@@..@.@@....@..@..@.@...@...@.@.@..@.@..@@...@.@@
................................@.@.....@.............@.@...@...........................@...............@.@...............@......
@.@.@.....@.........@...........@.....@.@......@..@.....@.@......@........@..@...@@.@.@......@......@.....@.....@..@@...@.@.@.@.@
............................@...........................@.......@.....................@.............................@............
@.@..@@@...@...@.@...@..@..............@@@.@@@@.........@....@.@@............@@.@.........@@@..@.@.@@...@...@@.@@@.......@.....@@
..........@.....................................@...@...........@.............@.....@...............@...@.................@.@....
@.....@.....@.@.........@.@.@...@.@.......@..@....@.....@.@.@.@.@.@......@..................@...@.....@@.@@.@.....@.@...@...@...@
....@.@.................@.................@.@...@.............@.................@...........@.......@...@...@.......@.......@....
@.@.@...@.....@@.@.....@@..@..@..@..@.@...@@.....@....@.@...@...@...@..@@@.@.@@...@.@..@....@.@...@@..@@@......@.@.@@...@.@@..@.@
................@...@.......@.......@...........@.@.@.@.............@...........@...............................@................
@...@.@.@.......@......@@.....................@...........@.@.@@...........@.......@......@...@...@.@...@....@@.@........@....@.@
..............@.@.......@.......@.......................@...........@...................@...@...@...........@...@...........@....
@....@..@...@@@..@.@.@..@@..@@@@...@....@...@....@@...@.@......@@@..@@.@..@.@..@..@.@.@.......@.....@......@..@@@@.@..@....@..@.@
................@.......@.....@.@.......@...@...............@.....@...@.........................@.......@........................
@.@.@.@.@.................@@@.......@.@......@@.@....@@.@.@.......@.@.........@.@...@.....@....@........@..@.@...@....@.@.......@
..@.@.....@.............@...@...................@...........................@...@...........@...................@.......@...@....
@.........@.....@@@..........@@.@.@..@...@....@.@..@@.@@@....@......@@@.@.....@..@..........@@....@.@.............@.............@
....@.@.@.......@...@...............@...@.............................@.@.................@.............@.......@.....@..........
@.@.@.....@@@...@@@...@.@.....@.@......@........@.......@.@.........@.@.....@.@...@.@...@.@......@..@...@.@...@.@.@.@........@..@
............@.........@.........@.@.....@.......@.......................@.......@...................@...........@...@.......@....
@@..@.@.@.@.@..@....@@.....@.....@@...@.....@@@..@.@....@..@.@..@.....@..@@.@..@..@.........@.@@@@@.@..@.......@.@....@@.@.@@.@@@
....@...........@...............................@.....@.@...@.....................@.....@...........@.......@.........@.@........
@...@.....@...........@......@..@.@...@.@...@@..@@....@...@..@@.......@.@...@@@...@....@.........@..........@@@...........@...@.@
....@...@...........@...@...............@...........................@.....@.....@...@...........................@.........@......
@.....@......@..@..@....@@@.@..@.........@.@..........@..@..@.......@...@@@.@.@.@....@..@.@.@.@@@@..@@....@.@.@.@.@..@@...@.@@@@@
............@...............@...............@...@.......@...................@.......@...........@...@...........@...@............
@......@@.....@.@@........@...@.@.@......@....@.@.................@.@...........@......@......@.......@...@.@.......@.......@...@
........@...................@...........@.....@.@.............@.....@...........@.............@.............@....................
@.@..@.@.@@.....@..@@.@@@.@@@........@@.@@...@..@....@@@@@....@.@......@@@@@@..@.@@..........@@@@...@.@.@@@.@.@@.....@.@@@@@....@
........@.......................@...........@.............@.@.......@.......................@...@................................
@@@.@@..@.....@.@..@....@@@.@.@.........@.............@@......@.....@.@.@.@@@......@..............@.........@.@...@.@.@...@.@.@.@
................................@.......@...........@...........@.......@...@...........@...........@...@.@.........@.......@....
@.@@....@.@...@.@.......@@...@@..@@.@.....@...............@.@..@@.@...@...........@...@..@.@@......@@.@...@..@@@@.@.....@.@@..@.@
................@.......@.......@.......@.......@...............................@.....@.........@...................@.@.....@....
@............@..........@.......@.@..@..@...@...@.......@.....@.@.........@..@@.@.@.@.@...@...@...@...@.....@@......@.@...@.....@
................@...........@...@...............................@................................................................
..@.@.@.@.@.@.@.@.@.@.@.@.@.@.@.@.@.@.@.@.@.@.@.@.@.@.@.@.@.@.@.@.@.@.@.@.@.@.@.@.@.@.@.@.@.@.@.@.@.@.@.@.@.@.@.@.@.@.@.@.@.@.@..
