type octile
height 33
width 33
map
..@.@.@.@.@.@.@.@.@.@.@.@.@.@.@..
......@.@.............@.....@....
@.@.@.@...@.......@@..@..@@.....@
........@...............@........
@..@....@.@@.@...@..@@....@..@..@
................@.......@.@...@..
@....@@...@...@.@.........@.....@
..@.............@.....@..........
@......@.@..@...@@...@.....@@...@
..........@.....@................
@...@...@...@....@.....@.@..@.@.@
........@.....@.@...@.......@....
@.@@.@..@......@@...@@...@......@
..................@..............
@...@.@...@....@......@.@..@.@@.@
............@...@...........@....
@.......@@@@.@..@.@@@@.@.@.@..@.@
....@...................@........
@..@@@......@.@@@.@.........@...@
............@...............@....
@.@@..@..@....@..@@....@@.@@@@@.@
........@.......@.....@..........
@.....@...@.@.@.....@.@.@@@...@.@
..@.@...@.......@.@...........@..
@@.@@...@@.@.@@@@@@...@@@@..@@..@
............@...@.......@........
@@@...@@.@@.@.@.@.........@.@...@
........@.......@................
@@....@@@.....@....@@@.....@@..@@
............@.@...............@..
@.@.....@.@.@...@.@.......@...@.@
................@................
..@.@.@.@.@.@.@.@.@.@.@.@.@.@.@..