type octile
height 9
width 9
map
..@.@.@..
.........
@.....@.@
..@......
@.@..@@.@
.........
@.@.@.@.@
.........
..@.@.@..